11111111111111111111111111
00001101000000000110100001
10101000001011010100000101
10100010101111010001010111
11111010100111111101010011
11111111111111111111111011